{
	"levelNumber": 2,
	"levelName": "Cave of Doom",
	"map": [
		"11111111111111111111111111111111111111111111111111",
		"11111111111111111111111111111111111111111111111111",														
		"11111111111111111111111111111111111111111111111111",
		"11111111111111111111111111111111111111111111111111",
		"11111111111111111111111111111111111111111111111111",	
		"11111111111111111111111111111111111111111111111111",
		"11111111111111111111111111111111111111111111111111",
		"11111111111111111111111111111111111111111111111111",
		"11111111111111111111111111111111111111111111111111",
		"11111111111111111111111111111111111111111111111111",
		"11111111111111111111111111111111111111111111111111",
		"11111111111111111111111111111111111111111111111111",
		"11111111111111111000000000000000000000111111111111",
		"11111111111111110011111110111111111110111111111111",
		"11111111111111111011111110111111111110111111111111",
		"11111111111111110011110000000000001110111111111111",
		"11111111111111111011110111110111101110111111111111",
		"11111111111111110011110000000111101110111111111111",
		"11111111111111111111111112111111101110111111111111",
		"11111111111111111011011111111111101110111111111111",
		"11111111111111111000011111111111101110111111111111",
		"11111111111111111101111100000011101110111111111111",
		"11111111111111111100011111111011101110111111111111",
		"11111111111111111111011111111011101110111111111111",														
		"11111111111111111111000000000000001110111111111111",
		"11111111111111111111111111111111111110111111111111",
		"11111111111111111111111111111111111110111111111111",
		"11111111111111111111111111111111100000111111111111",
		"11111111111111111111111111111111101111111111111111",
		"11111111111111300000000000000000001111111111111111",
		"11111111111111111111111111111111111111111111111111",
		"11111111111111111111111111111111111111111111111111",
		"11111111111111111111111111111111111111111111111111",
		"11111111111111111111111111111111111111111111111111",
		"11111111111111111111111111111111111111111111111111",
		"11111111111111111111111111111111111111111111111111",
		"11111111111111111111111111111111111111111111111111",
		"11111111111111111111111111111111111111111111111111",
		"11111111111111111111111111111111111111111111111111",														
		"11111111111111111111111111111111111111111111111111",
		"11111111111111111111111111111111111111111111111111",
		"11111111111111111111111111111111111111111111111111",
		"11111111111111111111111111111111111111111111111111",
		"11111111111111111111111111111111111111111111111111",
		"11111111111111111111111111111111111111111111111111",
		"11111111111111111111111111111111111111111111111111",
		"11111111111111111111111111111111111111111111111111",
		"11111111111111111111111111111111111111111111111111",
		"11111111111111111111111111111111111111111111111111",														
		"11111111111111111111111111111111111111111111111111"
	],
	"cellTypes": [
		{
			"char": "0",
			"label": "Path",
			"bgColor": "#000000",
			"isWalkable": true
		},	
		{
			"char": "1",
			"label": "Rock",
			"bgColor": "#898989",
			"image": "rock.png",
			"isWalkable": false
		},
		{
			"char": "2",
			"label": "Exit 1",
			"bgColor": "#898989",
			"image": "exit-down.png",
			"isWalkable": true
		},
		{
			"char": "3",
			"label": "Exit 2",
			"bgColor": "#898989",
			"image": "exit-left.png",
			"isWalkable": true
		}
	],
	"actionCells": [
		{
			"x": 14,
			"y": 29,
			"action": {
				"type": "new-level",
				"level": 1,
				"startX": 12,
				"startY": 38 
			}
		},
		{
			"x": 25,
			"y": 18,
			"action": {
				"type": "new-level",
				"level": 1,
				"startX": 40,
				"startY": 42 
			}
		},		
		{
			"x": 33,
			"y": 42,
			"action": {
				"type": "transform",
				"inventoryContains": "key-3",
				"transformTo": "0"
			}
		},
		{
			"x": 20,
			"y": 19,
			"action": {
				"type": "item",
				"image": "chest.png",
				"addGold": 125
			}
		},		
		{
			"x": 16,
			"y": 17,
			"action": {
				"type": "item",
				"image": "coin.png",
				"addGold": 25
			}
		},
		{
			"x": 16,
			"y": 15,
			"action": {
				"type": "item",
				"image": "coin.png",
				"addGold": 30
			}
		},
		{
			"x": 16,
			"y": 13,
			"action": {
				"type": "item",
				"image": "coin.png",
				"addGold": 50
			}
		},
		{
			"x": 17,
			"y": 19,
			"action": {
				"type": "item",
				"image": "chest.png",
				"addGold": 100
			}
		}		
	]
}
