{
	"levelNumber": 1,
	"levelName": "Greenfields",
	"map": [
		"11111111111111111111111111111111111111111111111111",
		"11111000000001110000000000000001111111110000011111",
		"11100000000000000000000555000000000000000000000011",
		"11002220000000000000000000000000000000000000000011",
		"10022222222222222222222222222220000500000000000011",
		"10002220000000000000000000000020000000000000000001",
		"10000000000000000000000000000020000000000000000001",
		"11100000000000000000000000000020000000000050000001",
		"11111111505000000005550000000020000000000000000001",
		"11110001111110500000005000000020000000000000000001",
		"11100000000011100000000000000020000000000000000001",
		"11000000000000111110000000011161110000000000000001",
		"11000000000000000111111111110020011111000000000011",
		"10000000000000000000000000000020000111111100000011",
		"10000000050000000000000000000020000000111111111111",
		"10000000000000000000000000000020000000000001111111",
		"11000000000000000000000000000020000000000000000111",
		"11000000000000000000005000000022222200050000000011",
		"11000000000000000000000000000000005200000000000011",
		"10000000005500000000000000000000000200000000000011",
		"10000000000000000000000000000000000200000000000011",
		"10000000000000000000000000000000000200000000000001",
		"10000000000000000000011111110000000200000005000001",
		"10000000000000000111111111111111000200000000000001",
		"10000000000001111111111111111111100200000000000001",
		"10005000011111111111111111111110000200000000000001",
		"10000000001111111111111111111110000200000000000001",
		"10000000000001111111111111115000000200000000000001",
		"10000000000000000111111115550000000200000000000001",
		"10000000500000001111111111555500000200000000000001",
		"11000000000000011111111111111111000200000000000001",
		"11000000000000000011111111111000000200000000000011",
		"11111110000000011111111111100000000200000000000011",
		"11111111110000111111111110000000000222220000000111",
		"11111111111111111115500000000000000000020000000111",
		"11111111111111133333500000050000000000022222000111",
		"11111111333333333300000000050000000000000002000011",
		"11111000003333333500000000000000000000000002000011",
		"11133050000073355000005000000000000000000002000011",
		"11330000003333355055000000000000000000000002000011",
		"13300000003333330055005000005000000000000002000001",
		"13300050000330000005000000000055550000533302000001",
		"13000000000300000000000000000000055005334332000001",
		"10000000003330000000000000000000000550222222000011",
		"10000000333333300000050000000000000000222222000011",
		"11000003333333330005000000000000000000000000000111",
		"11000333333333333000000000000000000000000000011111",
		"11003333333333333333300000000000000000000001111111",
		"111111#3333333333333333000000000000001111111111111",
		"11111111111111111111111111111111111111111111111111"
	],
	"cellTypes": [
		{
			"char": "0",
			"label": "Grass",
			"bgColor": "#bad684",
			"image": "texture.png",
			"isWalkable": true
		},
		{
			"char": "1",
			"label": "Water",
			"bgColor": "#7ea9cf",
			"isWalkable": false
		},
		{
			"char": "2",
			"label": "Road",
			"bgColor": "#c2b18c",
			"image": "texture.png",
			"isWalkable": true
		},
		{
			"char": "3",
			"label": "Rock",
			"bgColor": "#a9a9a9",
			"image": "rock.png",
			"isWalkable": false
		},
		{
			"char": "4",
			"label": "Cave Entrance 1",
			"bgColor": "#a9a9a9",
			"image": "cave-up.png",
			"isWalkable": true
		},
		{
			"char": "5",
			"label": "Tree",
			"bgColor": "#bad684",
			"image": "tree.png",
			"isWalkable": false
		}, 
		{
			"char": "6",
			"label": "Old Bridge",
			"bgColor": "#c2b18c",
			"image": "bridge.png",
			"isWalkable": true
		},
		{
			"char": "7",
			"label": "Cave Entrance 2",
			"bgColor": "#a9a9a9",
			"image": "cave-right.png",
			"isWalkable": true
		}		
	],
	"actionCells": [
		{
			"x": 40,
			"y": 42,
			"action": {
				"type": "new-level",
				"level": 2,
				"startX": 25,
				"startY": 18
			}
		},
		{
			"x": 12,
			"y": 38,
			"action": {
				"type": "new-level",
				"level": 2,
				"startX": 14,
				"startY": 29
			}
		},
		{
			"x": 45,
			"y": 5,
			"action": {
				"type": "item",
				"image": "coin.png",
				"addGold": 5
			}
		},
		{
			"x": 28,
			"y": 28,
			"action": {
				"type": "item",
				"image": "coin.png",
				"addGold": 10
			}
		},
		{
			"x": 16,
			"y": 28,
			"action": {
				"type": "item",
				"image": "coin.png",
				"addGold": 10
			}
		},
		{
			"x": 17,
			"y": 31,
			"action": {
				"type": "item",
				"image": "coin.png",
				"addGold": 25
			}
		},
		{
			"x": 4,
			"y": 43,
			"action": {
				"type": "item",
				"image": "chest.png",
				"addGold": 1000
			}
		}			
	]
}